{
  "width": 12,
  "height": 8,
  "tileSize": 32,
  "layers": [
    {
      "name": "background",
      "type": "background",
      "data": [
        [1, 1, 1, 1, 1, 1, 1, 1, 1, 1, 1, 1],
        [1, 1, 1, 1, 1, 1, 1, 1, 1, 1, 1, 1],
        [1, 1, 2, 2, 1, 1, 1, 1, 2, 2, 1, 1],
        [1, 1, 2, 2, 1, 1, 1, 1, 2, 2, 1, 1],
        [1, 1, 1, 1, 1, 3, 3, 1, 1, 1, 1, 1],
        [1, 1, 1, 1, 1, 3, 3, 1, 1, 1, 1, 1],
        [1, 1, 1, 1, 1, 1, 1, 1, 1, 1, 1, 1],
        [1, 1, 1, 1, 1, 1, 1, 1, 1, 1, 1, 1]
      ],
      "visible": true,
      "opacity": 1.0
    },
    {
      "name": "terrain",
      "type": "terrain",
      "data": [
        [0, 0, 0, 0, 0, 0, 0, 0, 0, 0, 0, 0],
        [0, 0, 0, 0, 0, 0, 0, 0, 0, 0, 0, 0],
        [0, 0, 4, 4, 0, 0, 0, 0, 4, 4, 0, 0],
        [0, 0, 4, 4, 0, 0, 0, 0, 4, 4, 0, 0],
        [0, 0, 0, 0, 0, 5, 5, 0, 0, 0, 0, 0],
        [0, 0, 0, 0, 0, 5, 5, 0, 0, 0, 0, 0],
        [0, 0, 0, 0, 0, 0, 0, 0, 0, 0, 0, 0],
        [0, 0, 0, 0, 0, 0, 0, 0, 0, 0, 0, 0]
      ],
      "visible": true,
      "opacity": 0.8
    }
  ],
  "playerSpawns": [
    {
      "x": 1,
      "y": 6
    },
    {
      "x": 2,
      "y": 6
    },
    {
      "x": 1,
      "y": 7
    },
    {
      "x": 2,
      "y": 7
    }
  ],
  "enemySpawns": [
    {
      "x": 9,
      "y": 1
    },
    {
      "x": 10,
      "y": 1
    },
    {
      "x": 9,
      "y": 2
    },
    {
      "x": 10,
      "y": 2
    }
  ]
}
